-3
12
0
7
0000000000000000
0000000011111110
0000000011111110
0000000011111110
0000000011111110
0000000011111110
0000000011111110
1111000011111110
