-20
23
-13
12
00000000000000000000000000000000000000000000
11111111111111111111111111111111111111111110
10000000000000000000000000000000000000000010
10000000000000000000000000000000000000000010
10000000000000000000000000000000000000000010
10000000000000000000000000000000000000000010
10000000000000000000000001111111000000000010
10000000000000000000000001111111000000000010
10000000000000000000101001111111000000000010
10000000000000000000000001111111000000000010
10000000000000000000000001111111000000000010
10000000000000000000000001111111000000000010
10000000000011111000000001111111000000000010
10000000000000000000000000000000000000000010
10000000000000000000000000000000000000000010
10000000000000000000000000000000000000000010
10000000000000000000000000000000000000000010
10000000000000000000000000000000000000000010
10000000000000000000000000000000000000000010
10000000000000000000000000000000000000000010
10000000000000000000000000000000000000000010
10000000000000000000000000000000000000000010
10000000000000000000000000000000000000000010
10000000000000000000000000000000000000000010
10000000000000000000000000000000000000000010
11111111111111111111111111111111111111111110
